# Defines

# NarfduinoBrushless
_NARFDUINO_ENABLE_BRUSHLESS_9	LITERAL1
_NARFDUINO_ENABLE_BRUSHLESS_10	LITERAL1


# NarfduinoBridge
_NARFDUINO_BRIDGE_ON_TRANSITION_TIME	LITERAL1
_NARFDUINO_BRIDGE_OFF_TRANSITION_TIME	LITERAL1
_NARFDUINO_PUSHER_MAX_CYCLE_TIME	LITERAL1
_NARFDUINOPIN_BRIDGE_RUN	LITERAL1
_NARFDUINOPIN_BRIDGE_STOP	LITERAL1


# NarfduinoBattery
_NARFDUINO_PIN_BATTERY 	LITERAL1
_NARFDUINO_BATTERY_CHECK_INTERVAL	LITERAL1
_NARFDUINO_BATTERY_NUM_SAMPLES	LITERAL1
_NARFDUINO_BATTERY_CALFACTOR	LITERAL1
_NARFDUINO_BATTERY_2S_MIN	LITERAL1
_NARFDUINO_BATTERY_2S_MAX	LITERAL1
_NARFDUINO_BATTERY_3S_MIN	LITERAL1
_NARFDUINO_BATTERY_3S_MAX	LITERAL1
_NARFDUINO_BATTERY_4S_MIN	LITERAL1
_NARFDUINO_BATTERY_4S_MAX	LITERAL1



# Classes

NarfduinoBrushless	KEYWORD1
NarfduinoBridge	KEYWORD1
NarfduinoBattery	KEYWORD1

# Methods

# NarfduinoBattery
Init	KEYWORD2
SetupSelectBattery	KEYWORD2
SetBatteryS	KEYWORD2
GetCurrentVoltage	KEYWORD2
GetBatteryS	KEYWORD2
GetBatteryPercent	KEYWORD2
IsBatteryFlat	KEYWORD2
ProcessBatteryMonitor	KEYWORD2

# NarfduinoBridge
HasJammed	KEYWORD2
GetBridgeSpeed	KEYWORD2
SetBridgeSpeed	KEYWORD2
DisableAntiJam	KEYWORD2
EnableAntiJam	KEYWORD2
StartBridge	KEYWORD2
StopBridge	KEYWORD2
ResetJam	KEYWORD2
PusherHeartbeat	KEYWORD2
ProcessBridge	KEYWORD2

# NarfduinoBrushless
UpdateSpeed	KEYWORD2